→ ← ◉ → ◎ 
■ → ■ → ↑ 
↓ ↑ ■ ■ ↑ 
← ◉ ■ ■ ↑ 
→ → → → ↑ 
